NO ./maps/lsd_assets/lsd1.xpm
SO ./maps/lsd_assets/lsd2.xpm
WE ./maps/lsd_assets/lsd3.xpm
EA ./maps/lsd_assets/lsd4.xpm
DO ./maps/lsd_assets/door.xpm

F 245,255,0
C 255,0,255

111111111111111111111
10000D000000001000001
101001010100100010001
1010010001D1111111101
101000100D0D000000101
1010001001D1001111101
10N00110100000100D001
10100D000010000001011
111111111111111111111